########################################
#                                      #
#                         *            #
#                       * *            #
#             **      **            ** #
#            *   *    **            ** #
# **        *     *   **               #
# **        *   * **    * *            #
#           *     *       *            #
#            *   *                     #
#             **                       #
#                                      #
#                                      #
#                                      #
#                                      #
#                                      #
#                                      #
#                                      #
########################################