########################################
#                                      #
#    *       *                         #
#  * *        *                        #
#   **      ***                        #
#                                      #
#                                      #
#                                      #
#                                      #
#                                      #
#                                      #
#                                      #
#                                      #
#                                      #
#                                      #
#                                      #
#                                      #
########################################