#################
#            *  #
#     ***    *  #
#            *  #
#################