#################
# *          *  #
# *   ***    *  #
# *          *  #
#################