############################
#                          #
#    ***                ** #
#      **         **     * #
#    ***            **     #
#                   ***    #
#                   **     #
#                          #
#            **            #
#***          **         **#
# ****        ***       *  #
############################