################
#              #
#     ***      #
#              #
################