############################
#         **               #
#   *      **           ** #
# * *  **         **     * #
#  ** *****         **     #
#          ***      ***    #
#    ***            **     #
#                          #
#            **            #
#***          **         **#
# ****        ***       *  #
############################