###***##########
#              #
#              #
#*             #
#*    ***      #
#*             #
#              #
*              #
*      ***     #
*              #
#              #
#  ***         #
#              #
########***#####