################################################################################
#                                                                              #
#                                                                              #
#                                                                              #
#   **                                                                         #
# *    *                                                                       #
#       *                                                                      #
# *     *                                                                      #
#  ******                                                                      #
#                                                                              #
#                                                                              #
#                                                                              #
#                                                                              #
#***    **                                                                     #
#     ** **                                                                    #
#     ****                                                                     #
#     ***                                                                      #
#      *                                                                       #
#    *   *                                                                     #
#         *                                                                    #
#    *    *                                                                    #
#     *****                                                                    #
#                                                                              #
#                                                                              #
#                                                                              #
#                                                                              #
################################################################################